XXXXXXXXXXXXXXXXXXXXXXXXXXXXXXXXXXXXXXXX
X--------------------------------------X
X--------------------------------------X
X--------------------------------------X
X--------------------------------------X
X--------------------------------------X
X--------------------------------------X
X--------------------------------------X
X---XXX-XXX-XX-XX-XXX-X---X--XXXX------X
X---X---X-X-X-X-X--X--XX--X-X----------X
X---X---X-X-X-X-X--X--X-X-X-X--XX------X
X---X---X-X-X-X-X--X--X--XX-X---X------X
X---XXX-XXX-X---X-XXX-X---X--XXX-------X
X--------------------------------------X
X----XXXX-XXX-XXX-X---X----------------X
X---X-----X-X-X-X-XX--X----------------X
X----XXX--X-X-X-X-X-X-X----------------X
X-------X-X-X-X-X-X--XX----------------X
X---XXXX--XXX-XXX-X---X----------------X
X--------------------------------------X
X--------------------------------------X
X--------------------------------------X
X--------------------------------------X
X--------------------------------------X
X--------------------------------------X
X--------------------------------------X
X--------------------------------------X
X--------------------------------------X
X--------------------------------------X
X--------------------------------------X
X--------------------------------------X
X--------------------------------------X
X--------------------------------------X
X--------------------------------------X
X--------------------------------------X
X--------------------------------------X
X--------------------------------------X
X--------------------------------------X
X--------------------------------------X
XXXXXXXXXXXXXXXXXXXXXXXXXXXXXXXXXXXXXXXX